{
    "levels": {
        "1": {
            "ballStartX": 0,
            "ballStartY": 7,
            "defaultSquareColor": "#303030",
            "visitedSquareColor": "#ee82ee",
            "gridBorderColor": "#00000092",
            "gridBorderColorVisited": "#fb69fbc4",
            "rows": 12,
            "columns": 7,
            "blocks": [
                { "x": 0, "y": 0},
                { "x": 2, "y": 1},
                { "x": 3, "y": 1},
                { "x": 2, "y": 2},
                { "x": 3, "y": 2},
                { "x": 4, "y": 2},
                { "x": 6, "y": 2},
                { "x": 2, "y": 3},
                { "x": 3, "y": 3},
                { "x": 6, "y": 3},
                { "x": 2, "y": 4},
                { "x": 3, "y": 4},
                { "x": 4, "y": 5},
                { "x": 3, "y": 7},
                { "x": 0, "y": 8},
                { "x": 1, "y": 8},
                { "x": 2, "y": 8},
                { "x": 3, "y": 8},
                { "x": 0, "y": 9},
                { "x": 1, "y": 9},
                { "x": 2, "y": 9},
                { "x": 3, "y": 9},
                { "x": 5, "y": 9},
                { "x": 6, "y": 9},
                { "x": 0, "y": 10},
                { "x": 1, "y": 10},
                { "x": 2, "y": 10},
                { "x": 3, "y": 10},
                { "x": 5, "y": 10},
                { "x": 6, "y": 10},
                { "x": 0, "y": 11},
                { "x": 1, "y": 11},
                { "x": 2, "y": 11},
                { "x": 3, "y": 11},
                { "x": 5, "y": 11},
                { "x": 6, "y": 11}
            ]
        },
        "2": {
            "ballStartX": 8,
            "ballStartY": 7,
            "defaultSquareColor": "#303030",
            "visitedSquareColor": "#ee82ee",
            "gridBorderColor": "#00000092",
            "gridBorderColorVisited": "#fb69fbc4",
            "rows": 10,
            "columns": 9,
            "blocks": [

                { "y": 0, "x": 5},
                { "y": 0, "x": 6},
                { "y": 0, "x": 7},
                { "y": 0, "x": 8},
                { "y": 1, "x": 8},
                { "y": 2, "x": 1},
                { "y": 2, "x": 2},
                { "y": 2, "x": 3},
                { "y": 2, "x": 6},
                { "y": 2, "x": 8},
                { "y": 3, "x": 1},
                { "y": 3, "x": 8},
                { "y": 4, "x": 1},
                { "y": 4, "x": 3},
                { "y": 4, "x": 4},
                { "y": 4, "x": 6},
                { "y": 5, "x": 1},
                { "y": 5, "x": 3},
                { "y": 5, "x": 4},
                { "y": 5, "x": 6},
                { "y": 6, "x": 1},
                { "y": 6, "x": 6},
                { "y": 8, "x": 1},
                { "y": 8, "x": 3},
                { "y": 8, "x": 8},
                { "y": 9, "x": 4},
                { "y": 9, "x": 7},
                { "y": 9, "x": 8}
            ]
        }
    }
}